#tiles
grass.png
path.png
water0.png, water1.png, solid

#map
16 10
1 1 0 0 0 0 0 0 0 2 2 2 2 2 2 2
0 1 1 1 1 1 1 1 0 0 2 2 2 2 2 2
0 0 0 0 0 0 0 1 1 0 0 2 2 2 2 2
0 0 0 0 0 0 0 0 1 1 0 0 2 2 2 2
0 0 0 0 0 0 0 0 0 1 1 0 0 2 2 2
0 0 1 0 0 0 0 0 0 0 1 1 0 0 2 2
0 0 1 0 0 0 0 0 0 0 0 1 1 0 0 2
0 1 1 1 0 0 0 0 0 0 0 0 1 1 0 0
0 0 1 0 0 0 0 0 0 0 0 0 0 1 1 1
0 0 0 0 0 0 0 0 0 0 0 0 0 0 1 1

#player
0 0

#transition
15 9 level.txt 0 0